1111111111111111111111111111111111
1E000000000C0000000000000000000001
1011110100100000101001000000010101
1011110010101010001001000000010101
1P000C00000000000000000000000000C1
1111111111111111111111111111111111
