1111111111111111111111111111111111
1E000000000C00000000000000000000E1
1011110C0010000010100100000001C101
101111001010101C001001000000010101
1P000C00000000000000000000000000C1
1111111111111111111111111111111111
