1111111111111111111111111111111111111111111111111111111
111111E000000000000000000000000000000000000000000001111
111E001111111111100111111110000000000001111100011111111
111101111000111110C111111110000001010111111000000000011
1000000100000010111111110101111001110000001000000100111
1000010111000000100001000000100000011110000000111100011
1C00000001000000001000000000100000000010000000011000001
1000000000011000000000100000000010000000000100000000011
1111111100000111111111100000000111111110000111110000111
10011110000000011000000010000000000100000000C00000111C1
111E000011011111100001111111C00111111100011111000011101
1111111110000000001000000000011100000000001100000000001
1111111C0000000010000000000110000000011110000111000P001
1000000001011111100000111111110C00000000001111111001111
1111111111111111111111111111111111111111111111111111111
