111111111111111111111111111111111111111111111111111111111111111111111111111111111111
111111E00000000000000000000000000000000000000000000000000000000000000000000000111111
111000111111111110011111111111111111110000000000000000011111111111101001100011111111
111101111000111110C11111111000000101011111100000011100000000011111100011111111111111
100000010000001011111111010111100000111111110000001000000100000001100000010001011111
100001011100000010000100000010000001111111000000011111111100000011111000100000011111
1C000000010000000010000000001000000000100000000110000000110000000111000E111000011111
100000000001100000000010000000001000000000010000000001000000010000000100001100011111
111111110000011111111110000000011111111000011111000011111011111111110000001000011111
10011110000000011000000010000000000100000000C0000000101000111C0000000001001110111111
111E000011011111100001111111C0011111110001111100001111110011111111111100111110111111
111111111000000000100000000001110000000000110000000000000000001100000110000000111111
1111111C000000001000000000011000000001111000011111111111000P000111110000111001111111
111111111111111111111111111111111111111111111111111111111111111111111111111111111111
