111111111111111111111111111111111111111111111111111111111111111
111111E00000000000000000000000000000000000000000000000000111111
111E00111111111110011111111000000000000111111101001100011111111
111101111000111110C11111111000000101011111100000011100000000011
100000010000001011111111010111100000111111110000001000000100111
100001011100000010000100000010000001111111000000011111111100011
1C0000000100000000100000000010000000001000000001100000001100001
100000000001100000000010000000001000000000010000000001000000011
111111110000011111111110000000011111111000011111000011111011111
10011110000000011000000010000000000100000000C0000000101000111C1
111E000011011111100001111111C0011111110001111100001111110011001
111111111000000000100000000001110000000000110000000000000000001
1111111C000000001000000000011000000001111000011111111111000P001
111111111111111111111111111111111111111111111111111111111111111
